aml:ExternalReference1	aml
aml:InstanceHierarchy1	aml
aml:Attribute1	aml
aml:CAEXFile1	aml
aml:AdditionalInformation2	aml
aml:ExternalReference2	aml
aml:InternalElement1	aml
aml:RefSemantic1	aml
aml:AdditionalInformation1	aml
opcua:Value11	opcua
opcua:Value7	opcua
opcua:UAVariable3	opcua
opcua:References14	opcua
opcua:Value1	opcua
opcua:References8	opcua
opcua:References2	opcua
opcua:UAVariable8	opcua
opcua:Value10	opcua
opcua:Value6	opcua
opcua:UAVariable2	opcua
opcua:References13	opcua
opcua:References7	opcua
opcua:UAObject4	opcua
opcua:References1	opcua
opcua:UAVariable7	opcua
opcua:Value5	opcua
opcua:UAVariable1	opcua
opcua:UAVariable11	opcua
opcua:References12	opcua
opcua:References6	opcua
opcua:UAObject3	opcua
opcua:UAVariable6	opcua
opcua:Value4	opcua
opcua:UAVariable10	opcua
opcua:References11	opcua
opcua:References5	opcua
opcua:UAObject2	opcua
opcua:Aliases1	opcua
opcua:Value9	opcua
opcua:UAVariable5	opcua
opcua:UANodeSet1	opcua
opcua:Value3	opcua
opcua:References10	opcua
opcua:References4	opcua
opcua:UAObject1	opcua
opcua:Value8	opcua
opcua:UAVariable4	opcua
opcua:References15	opcua
opcua:Value2	opcua
opcua:References9	opcua
opcua:NamespaceUris1	opcua
opcua:References3	opcua
opcua:UAVariable9	opcua
